//####///
###  ####
#     $ #
#    #$ #
# . .#@ #
#########
